1 
3 
0 
0 
10 
15 
7 
4 
###############
#     #       #
# ### # ##### #
# #   #     # #
# # ##### # # #
# #     # # # #
# ##### # # # #
# @     #   # #
# ########### #
###############
