2
3
0
0
10
15
2
2
0
0
2
8
6
5
11
###############
# @   #    c  #
# ##### ##### #
# #c c#     # #
# # ##### #%# #
#       ###   #
# c#### # # # #
#     % #   # #
#&###########x#
###############
