2
3
0
0
10
15
2
8
0
0
2
8
6
5
11
###############
#     # @     #
# ### # ##### #
# #  c#     # #
# #########%# #
#  #    # #x# #
#  #### # ### #
#c    % #   # #
# # &########c#
###############
