1
3
0
0
10
15
8
2
0
0
2
8
6
5
11
###############
#     #       #
# ### # ##### #
# #   #     # #
# # ##### #%# #
#       # # # #
#  #### # # # #
# @   % #   # #
# ########### #
###############
