1
3
0
0
10
15
7
2
2
7
7
4
15
###############
#     #       #
# ### # ##### #
# #   #     # #
# # ##### #%# #
#       # # # #
#  #### # # # #
# @   % #   # #
# ########### #
###############
